1111111111
1001C100P1
1101010111
11C000E111
1111111111