1111111111111
1C010C00000C1
1000011111001
1P00110000E01
1111111111111