1111111111111
11E0C1100P111
1100001000111
1111111111111