1111111111
1001C000P1
11E1010111
11C0000111
1111111111