111111111111111111
1E10001C100000P011
110000101000001111
11000C00C011111111
111111111111111111